+---+---+---+---+---+---+---+---+---+---+
                |       |       |       |
                |       |       |       |
+   +---+---+   +   +---+   +   +   +   +
|   |       |   |           |       |   |
|   |       |   |           |       |   |
+   +   +   +   +---+---+   +---+---+   +
|   |   |   |           |   |       |   |
|   |   |   |           |   |       |   |
+   +   +   +---+---+   +   +   +   +   +
|       |   |       |   |   |   |       |
|       |   |       |   |   |   |       |
+   +   +   +   +   +   +   +   +---+---+
|   |   |       |   |       |       |   |
|   |   |       |   |       |       |   |
+   +---+---+---+   +---+---+---+   +   +
|   |           |   |               |   |
|   |           |   |               |   |
+   +   +---+   +   +---+   +---+---+   +
|   |       |   |       |       |       |
|   |       |   |       |       |       |
+   +   +   +---+---+   +---+   +   +---+
|   |   |           |       |   |   |   |
|   |   |           |       |   |   |   |
+   +---+---+---+   +---+   +   +   +   +
|           |   |           |   |       |
|           |   |           |   |       |
+---+---+   +   +---+---+---+   +   +   +
|               |                   |    
|               |                   |    
+---+---+---+---+---+---+---+---+---+---+