+-+-+-+-+
        |
+ +-+-+ +
|   |   |
+-+ + +-+
|   | | |
+ +-+ + +
|   |    
+-+-+-+-+