+-+-+-+-+-+-+-+-+-+-+-+-+-+-+-+-+-+-+
    |   |   |     |       |   |     |
+ + +-+ +-+ + +-+ + +-+-+ + + + + + +
| |   | |   | | | |     | | | | | | |
+ +-+ + + +-+ + + +-+-+ + + + + + + +
| | | |       |   |     |   |   | | |
+ + + +-+ +-+-+-+-+-+-+ +-+-+-+-+ +-+
|   |   | |     |   | | | |         |
+ +-+ +-+ + +-+ +-+ + + + + +-+-+-+ +
| | |     | |   |   |   | |   |   | |
+ + +-+-+-+-+ +-+ +-+-+ + + + + +-+ +
| |   |     | |   |   | |   | |   | |
+ +-+ + +-+ + + + + + + +-+ + +-+ + +
|   | | |   | | | | |   | | | | |   |
+-+ + + + +-+ + + + + +-+ + + + +-+ +
| |     | |     | | |   |   | |     |
+ +-+ +-+ + + +-+-+ +-+ +-+-+ +-+-+-+
|   | | |   |       |   | |   |     |
+ +-+ + +-+-+-+-+-+-+ +-+ + +-+ + +-+
| |   | | |       |   |   |   | |   |
+ + + + + + +-+-+ + +-+-+ +-+ + +-+ +
| | | | |     |   | | |     |   | | |
+ + + + +-+-+ +-+-+ + + +-+ + +-+ + +
|   | |         |   | | |   | |     |
+-+-+-+-+-+-+-+ + +-+ + + +-+-+ +-+-+
| |   |   |   |   | |   |     |     |
+ + + +-+ + + +-+-+ +-+ +-+-+ + +-+ +
| | |       | |   |   |     |   |   |
+ + +-+-+-+-+ + + +-+ +-+-+-+-+-+ +-+
|   | |   |     | |   |         |   |
+-+ + + + +-+ + + + +-+ +-+-+ +-+-+ +
|   |   |   | | |   |   |       |   |
+ +-+-+-+ + +-+ +-+-+ +-+-+-+ + +-+ +
|     |   | |   |   | |       |     |
+-+-+ + +-+ + + + + + + +-+-+-+-+-+-+
|     |   |   |   |   |              
+-+-+-+-+-+-+-+-+-+-+-+-+-+-+-+-+-+-+