+-+-+-+-+-+-+-+-+-+-+
      |             |
+-+-+ + +-+-+ + +-+ +
|     | | |   | |   |
+ +-+-+ + + +-+-+ +-+
|       |   |       |
+-+-+-+-+-+ + +-+ + +
| |     |   | | | | |
+ + +-+ +-+-+ + + + +
|   |         |   |  
+-+-+-+-+-+-+-+-+-+-+