+---+---+---+---+---+---+---+---+---+---+
    |       |                       |   |
    |       |                       |   |
    |       |                       |   |
+   +   +   +   +   +---+---+---+   +   +
|   |   |   |   |           |           |
|   |   |   |   |           |           |
|   |   |   |   |           |           |
+   +   +   +   +---+---+   +   +---+   +
|       |       |           |   |       |
|       |       |           |   |       |
|       |       |           |   |       |
+---+---+---+---+   +---+---+   +   +---+
|   |           |   |   |       |       |
|   |           |   |   |       |       |
|   |           |   |   |       |       |
+   +   +---+   +   +   +   +---+---+   +
|       |   |       |   |   |           |
|       |   |       |   |   |           |
|       |   |       |   |   |           |
+   +---+   +---+---+   +   +   +---+---+
|       |                   |            
|       |                   |            
|       |                   |            
+---+---+---+---+---+---+---+---+---+---+