+---+---+---+---+---+---+
    |       |           |
    |       |           |
+   +   +   +---+   +   +
|       |           |   |
|       |           |   |
+---+---+---+---+---+   +
|           |           |
|           |           |
+   +---+   +   +---+   +
|   |   |       |       |
|   |   |       |       |
+   +   +---+---+   +---+
|       |       |       |
|       |       |       |
+---+   +   +---+---+   +
|       |                
|       |                
+---+---+---+---+---+---+